9226,9226,9226,9226,9226,9226,9226,9226,9226,9226,9226,9226,9226,9226,9226,9226,9226,9226,9226,9226
9226,9226,9226,9226,9226,9226,9226,9226,9226,9226,9226,9226,9226,9226,9226,9226,9226,9226,9226,9226
9226,9226,9226,9226,9226,9226,9226,9226,9226,9226,9226,9226,9226,9226,9226,9226,9226,9226,9226,9226
9226,9226,9226,9226,9226,9226,9226,9226,9226,9226,9226,9226,9226,9226,9226,9226,9226,9226,9226,9226
9226,9226,9226,9226,9226,9226,9226,9226,9226,9226,9226,9226,9226,9226,9226,9226,9226,9226,9226,9226
9224,9225,9226,9226,9224,9225,9226,9226,9224,9225,9226,9226,9224,9225,9226,9226,9224,9225,9226,9226
9416,9417,9418,9226,9416,9417,9418,9226,9416,9417,9418,9226,9416,9417,9418,9226,9416,9417,9418,9226
9608,9609,9610,9226,9608,9609,9610,9226,9608,9609,9610,9226,9608,9609,9610,9226,9608,9609,9610,9226
9800,9801,9802,9226,9800,9801,9802,9226,9800,9801,9802,9226,9800,9801,9802,9226,9800,9801,9802,9226
9992,9993,9994,9226,9992,9993,9994,9226,9992,9993,9994,9226,9992,9993,9994,9226,9992,9993,9994,9226
10184,10185,10186,9226,10184,10185,10186,9226,10184,10185,10186,9226,10184,10185,10186,9226,10184,10185,10186,9226
9224,9225,9226,9226,9224,9225,9226,9226,9224,9225,9226,9226,9224,9225,9226,9226,9224,9225,9226,9226
9416,9417,9418,9226,9416,9417,9418,9226,9416,9417,9418,9226,9416,9417,9418,9226,9416,9417,9418,9226
9608,9609,9610,9226,9608,9609,9610,9226,9608,9609,9610,9226,9608,9609,9610,9226,9608,9609,9610,9226
9800,9801,9802,9226,9800,9801,9802,9226,9800,9801,9802,9226,9800,9801,9802,9226,9800,9801,9802,9226
9992,9993,9994,9226,9992,9993,9994,9226,9992,9993,9994,9226,9992,9993,9994,9226,9992,9993,9994,9226
10184,10185,10186,9226,10184,10185,10186,9226,10184,10185,10186,9226,10184,10185,10186,9226,10184,10185,10186,9226
9224,9225,9226,9226,9224,9225,9226,9226,9224,9225,9226,9226,9224,9225,9226,9226,9224,9225,9226,9226
9416,9417,9418,9226,9416,9417,9418,9226,9416,9417,9418,9226,9416,9417,9418,9226,9416,9417,9418,9226
9608,9609,9610,9226,9608,9609,9610,9226,9608,9609,9610,9226,9608,9609,9610,9226,9608,9609,9610,9226
9800,9801,9802,9226,9800,9801,9802,9226,9800,9801,9802,9226,9800,9801,9802,9226,9800,9801,9802,9226
9992,9993,9994,9226,9992,9993,9994,9226,9992,9993,9994,9226,9992,9993,9994,9226,9992,9993,9994,9226
10184,10185,10186,9226,10184,10185,10186,9226,10184,10185,10186,9226,10184,10185,10186,9226,10184,10185,10186,9226
9224,9225,9226,9226,9224,9225,9226,9224,9224,9225,9226,9226,9224,9225,9226,9226,9224,9225,9226,9226
9416,9417,9418,9226,9416,9417,9418,9226,9416,9417,9418,9226,9416,9417,9418,9226,9416,9417,9418,9226
9608,9609,9610,9226,9608,9609,9610,9226,9608,9609,9610,9226,9608,9609,9610,9226,9608,9609,9610,9226
9800,9801,9802,9226,9800,9801,9802,9226,9800,9801,9802,9226,9800,9801,9802,9226,9800,9801,9802,9226
9992,9993,9994,9226,9992,9993,9994,9226,9992,9993,9994,9226,9992,9993,9994,9226,9992,9993,9994,9226
10184,10185,10186,9226,10184,10185,10186,9226,10184,10185,10186,9226,10184,10185,10186,9226,10184,10185,10186,9226
9226,9226,9226,9226,9226,9226,9226,9226,9226,9226,9226,9226,9226,9226,9226,9226,9226,9226,9226,9226
