4454,4454,4454,4454,4454,4454,4454,4454,4454,4454
4454,4453,4453,4453,4453,4453,4453,4453,4259,4454
4454,4453,4259,4453,4453,4453,4453,4453,4259,4454
4454,4453,4453,4453,4453,4453,4453,4453,4453,4454
4454,4453,4453,4453,4453,4453,4453,4453,4453,4454
4454,4453,4453,4259,4453,4453,4259,4453,4453,4454
4454,4453,4453,4262,4453,4453,4453,4453,4262,4454
4454,4453,4453,4453,4453,4453,4453,4453,4453,4454
4454,4453,4453,4453,4453,4453,4453,4259,4453,4454
4454,4453,4259,4259,4259,4453,4453,4453,4262,4454
4454,4453,4453,4453,4453,4453,4453,4453,4453,4454
4454,4454,4454,4454,4454,4454,4454,4454,4454,4454